....................
....................
....................
....................
....................
....................
.............G......
.........GGG..G.....
.........###...G....
................G...
....GGG.........G...
....###..........G..
.................G..
.1................X.
####..............#.
