Terra/crawl.txt
...1..+..=..A..()..X
...#################
....................
...........T........
..........@-........
..........-.........
.............G......
.........G^G..G.....
.........###...G...<
................G...
....G^G.........G..<
....###..........G..
..............*..+..
.1..*............-X.
####..............#.
